11111111111111111111
111101111E1111000011
111000011P1100000011
1100C000111000010001
100111000000C1110001
10110000000011110001
10110000000011000001
101000C0111110000011
1C1001111000100C0111
11111111111111111111